###############################
#     s* *    *   *  * * *    #
# # # #*# # #*#*# # # #*#*#*# #
#   *    f***  *    1 *   * * #
# # # # # #*# # #*#*# # # # #*#
#          1 **  *  *         #
# # # # # # # # # #*# #*# # # #
#b  *      *  *      *        #
# # # # #*# # # #*#*# # # # # #
#*    **  *       *    2      #
# #*# # # # # # #*# # # # # # #
#           *   *  *          #
###############################
