###############################
#     s* *    *   *  * * *    #
# # # #*# # #*#*# # # #*#*#*# #
#   *2   f***  *    1 *   * * #
#x# # # # #*# # #*#*# # # # #*#
#          1 **  * 4*         #
# # # # # # # # # #*# #*# # # #
#b  *      *  *      *        #
# # # # #*# # # #*#*# # # # # #
#*  3 **  *       *    2      #
# #*# # # # # # #*# # # # # # #
#           *   *  *          #
###############################
