###############################
#     s* *    *   *  * * *    #
# # # #*# # #*#*# # # #*#x#*# #
#   *   f***  *      *   * *  #
#x# # # # #*# # #*#*# # # # #*#
#     1       **  *  *   1    #
# # # # # # # # # #*# #*# # # #
#   *      *  *      *        #
# # # # #*# # # #*#*# # # # # #
#*    **  *       *           #
# #*# # # # # # #*# # # # # # #
#           *   *  *      1   #
###############################
