###############################
#     s* *    *   *  * * *    #
# # # #*# # #*#*# # # #*#*#*# #
#   * 2  f***  *    1 *   * * #
#x# # # # #*# # #*#*# # # # #*#
#          1 **  *  *         #
# # # # # # # # # #*# #*# # # #
#b  *      *  * 4    *        #
# # # # #*# # # #*#*# # # # # #
#*    **  *       *    2      #
# #*# # # # # # #*# # # # # # #
#     3     *   *  *          #
###############################
