###############################
#     s* *    *   *  * * *    #
# # # #*# # #*#*# # # #*#x#*# #
#   *   f***  *      *   * *  #
# # # # # #*# # #*#*# # # # #*#
#     1       **  *  *  1     #
# # # # # # # # # #*# #*# # # #
#1  *      *  *      *        #
# # # # #*# # # #*#*# # # # # #
#*    **  *       *           #
# #*# # # # # # #*# # # # # # #
#           *   *  *     1    #
###############################
