###############################
#     s* *    *   *  * * *    #
# # # #*# # #*#*# # # #*#*#*# #
#   *o   f***  *    1 *   * * #
#x# # # # #*# # #*#*# # # # #*#
#          1 **  * 4*         #
# #o# # # # # # # #*# #*# # # #
#b  *      *  *      *        #
# # # # #*# # # #*#*# # # # # #
#*    **  *       *    2      #
# #*# # # # # # #*# # # # # # #
#           *   *  *          #
###############################
