###############################
#     s* *    *   *  * * *    #
# # # #*# # #*#*# # # #*#*#*# #
#   *o   f***  *      *   * * #
#x# # # # #*# # #*#*# # # # #*#
#    1        **  *  *        #
# #o# # # # # # # #*# #*# # # #
#b  *      *  *      *        #
# # # # #*# # # #*#*# # # # # #
#*    **  *       *     1     #
# #*# # # # # # #*# # # # # # #
#     1     *   *  *          #
###############################
